10
16
2
2
7
13
################
#--------------#
#-S------#-----#
#--------#-----#
#-------#------#
#--------------#
#--------------#
#------------E-#
#--------------#
################
