15
15
1
3
11
11
###############
##-S---------##
###-##-#####-##
###-##-#####-##
#---##---###-##
#-####-----#-##
#-####---#-#-##
#-######-#-#-##
#-######-#---##
#-##-----######
#-##-#-########
#-##-------E--#
#-###########-#
#-------------#
###############
