15
16
1
2
13
12
################
#-S----#--#-#-##
#----#--------##
#--###--#--#--##
#-----##------##
#----#--------##
###---#-#####-##
#---#-#-------##
#---#-###-#---##
#--#-#-----#--##
#-#----#----#-##
#-----#-------##
#-----#-------##
#######--###E-##
################
